1
1
0
0000000000
0BBBBBBBB0
0BPBBBBBB0
0BBBBBBBB0
0BBBBBBBB0
0BBBBBBBB0
0BBBBBBBB0
0BBBBBBBB0
0BMBBBBBB0
0BBBBBBBB0
0BBBBBBBB0
0BBBBBBBB0
0BBBBBBBB0
0BBBBBBBB0
0BBBBBBBB0
0000000000
F